#0,#0,#0,#0,#0,#0,#0,#0,#0,#0,#0,#0,#0,#0,#0,#0,#0,#0,#0,#0,#0,#0,#0,#0,#0,#0,#0,#0,#0,#0,#0,#0,#0,#0,#0,#0,#0,#0,#0,#0,#0,#0,#0,#0,#0,#0,#0,#0
#0,#0,#0,#0,#0,#0,#0,#0,#0,#0,#0,#0,#0,#0,#0,#0,#0,#0,#0,#0,#0,#0,#0,#0,#0,#0,#0,#0,#0,#0,#0,#0,#0,#0,#0,#0,#0,#0,#0,#0,#0,#0,#0,#0,#0,#0,#0,#0
#0,#0,#0,#0,#0,#0,#0,#0,#0,#0,#0,#0,#0,#0,#0,#0,#0,#0,#0,#0,#0,#0,#0,#0,#0,#0,#0,#0,#0,#0,#0,#0,#0,#0,#0,#0,#0,#0,#0,#0,#0,#0,#0,#0,#0,#0,#0,#0
#0,#0,#0,#0,#0,#0,#0,#0,#0,#0,#0,#0,#0,#0,#0,#0,#0,#0,#0,#0,#0,#0,#0,#0,#0,#0,#0,#0,#0,#0,#0,#0,#0,#0,#0,#0,#0,#0,#0,#0,#0,#0,#0,#0,#0,#0,#0,#0
#0,#0,#0,#0,  ,  ,  ,  ,  ,  ,  ,  ,  ,  ,  ,  ,  ,  ,  ,  ,  ,  ,  ,  ,  ,  ,  ,#5,#5,#5,#5,#5,#5,#5,#5,#5,#5,#5,#5,#5,#5,#5,#5,#5,#0,#0,#0,#0
#0,#0,#0,#0,  ,  ,  ,  ,  ,  ,  ,  ,  ,  ,  ,  ,  ,  ,  ,  ,  ,  ,  ,  ,  ,  ,  ,#5,#5,#5,#5,#5,#5,#5,#5,#5,#5,#5,#5,#5,#5,#5,#5,#5,#0,#0,#0,#0
#0,#0,#0,#0,  ,  ,  ,  ,  ,  ,  ,  ,  ,  ,  ,  ,  ,  ,  ,  ,  ,  ,  ,  ,  ,  ,  ,#5,#5,#5,#5,#5,#5,#5,#5,#5,#5,#5,#5,#5,#5,#5,#5,#5,#0,#0,#0,#0
#0,#0,#0,#0,  ,  ,  ,  ,  ,  ,  ,  ,  ,  ,  ,  ,  ,  ,  ,  ,  ,  ,  ,  ,  ,  ,  ,#5,#5,#5,#5,#5,#5,#5,#5,#5,#5,#5,#5,#5,#5,#5,#5,#5,#0,#0,#0,#0
#0,#4,#4,#4,  ,  ,  ,  ,  ,  ,  ,  ,  ,  ,  ,  ,  ,  ,  ,  ,  ,  ,  ,  ,  ,  ,  ,#5,#5,#5,#5,#5,#5,#5,#5,#5,#5,#5,#5,#5,#5,#5,#5,#5,#0,#0,#0,#0
#0,#4,#4,#4,  ,  ,  ,  ,  ,  ,  ,  ,  ,  ,  ,  ,  ,  ,  ,  ,  ,  ,  ,  ,  ,  ,  ,#5,#5,#5,#5,#5,#5,#5,#5,#5,#5,#5,#5,#5,#5,#5,#5,#5,#0,#0,#0,#0
#0,#4,#4,#4,  ,  ,  ,  ,  ,  ,  ,  ,  ,  ,  ,  ,  ,  ,  ,  ,  ,  ,  ,  ,  ,  ,  ,#5,#5,#5,#5,#5,#5,#5,#5,#5,#5,#5,#5,#5,#5,#5,#5,#5,#0,#0,#0,#0
#0,#4,#4,#4,  ,  ,  ,  ,  ,  ,  ,  ,  ,  ,  ,  ,  ,  ,  ,  ,  ,  ,  ,  ,  ,  ,  ,  ,  ,  ,  ,  ,  ,  ,  ,  ,  ,  ,#7,#7,#7,#7,#7,  ,#0,#0,#0,#0
#0,#4,#4,#4,  ,  ,  ,  ,  ,  ,  ,  ,  ,  ,  ,  ,  ,  ,  ,  ,  ,  ,  ,  ,  ,  ,  ,  ,  ,  ,  ,  ,  ,  ,  ,  ,  ,  ,#7,#7,#7,#7,#7,  ,#0,#0,#0,#0
#0,#4,#4,#4,  ,  ,  ,  ,  ,  ,  ,  ,  ,  ,  ,  ,  ,  ,  ,  ,  ,  ,  ,  ,  ,  ,  ,  ,  ,  ,  ,  ,  ,  ,  ,  ,  ,  ,#7,#7,#7,#7,#7,  ,#0,#0,#0,#0
#0,#4,#4,#4,  ,  ,  ,  ,  ,  ,  ,  ,  ,  ,  ,  ,  ,  ,  ,  ,  ,  ,  ,  ,  ,  ,  ,  ,  ,  ,  ,  ,  ,  ,  ,  ,  ,  ,#7,#7,#7,#7,#7,  ,#0,#0,#0,#0
#0,#0,#0,#0,  ,  ,  ,  ,  ,  ,  ,  ,  ,  ,  ,  ,  ,  ,  ,  ,  ,  ,  ,  ,  ,  ,  ,  ,  ,  ,  ,  ,  ,  ,  ,  ,  ,  ,#7,#7,#7,#7,#7,  ,#0,#0,#0,#0
#0,#0,#0,#0,  ,  ,  ,  ,  ,  ,  ,  ,  ,  ,  ,  ,  ,  ,  ,  ,  ,  ,  ,  ,  ,  ,  ,  ,  ,  ,  ,  ,  ,  ,  ,  ,  ,  ,  ,  ,  ,  ,  ,  ,#0,#0,#0,#0
#0,#0,#0,#0,  ,  ,  ,  ,  ,  ,  ,  ,  ,  ,  ,  ,  ,  ,  ,  ,  ,  ,  ,  ,  ,  ,  ,  ,  ,  ,  ,  ,  ,  ,  ,  ,  ,  ,  ,  ,  ,  ,  ,  ,#0,#0,#0,#0
#0,#0,#0,#0,  ,  ,  ,  ,  ,  ,  ,  ,  ,  ,  ,  ,  ,  ,  ,  ,  ,  ,  ,  ,  ,  ,  ,  ,  ,  ,  ,  ,  ,  ,  ,  ,  ,  ,  ,  ,  ,  ,  ,  ,#0,#0,#0,#0
#0,#0,#0,#0,  ,  ,  ,  ,  ,  ,  ,  ,  ,  ,  ,  ,  ,  ,  ,  ,  ,  ,  ,  ,  ,  ,  ,  ,  ,  ,  ,  ,  ,  ,  ,  ,  ,  ,  ,  ,  ,  ,  ,  ,#0,#0,#0,#0
#0,#0,#0,#0,  ,  ,  ,  ,  ,  ,  ,  ,  ,  ,  ,  ,  ,  ,  ,  ,  ,  ,  ,  ,  ,  ,  ,  ,  ,  ,  ,  ,  ,  ,  ,  ,  ,  ,  ,  ,  ,  ,  ,  ,#0,#0,#0,#0
#0,#0,#0,#0,#6,#6,#6,#6,#6,  ,  ,  ,  ,  ,  ,  ,  ,  ,  ,  ,  ,  ,  ,  ,  ,  ,  ,  ,  ,  ,  ,  ,  ,  ,  ,  ,  ,  ,  ,  ,  ,  ,  ,  ,#0,#0,#0,#0
#0,#0,#0,#0,#6,#6,#6,#6,#6,  ,  ,  ,  ,  ,  ,  ,  ,  ,  ,  ,  ,  ,  ,  ,  ,  ,  ,  ,  ,  ,  ,  ,  ,  ,  ,  ,  ,  ,  ,  ,  ,  ,  ,  ,#0,#0,#0,#0
#0,#0,#0,#0,#6,#6,#6,#6,#6,  ,  ,  ,  ,  ,  ,  ,  ,  ,  ,  ,  ,  ,  ,  ,  ,  ,  ,  ,  ,  ,  ,  ,  ,  ,  ,  ,  ,  ,  ,  ,  ,  ,  ,  ,#0,#0,#0,#0
#0,#0,#0,#0,#6,#6,#6,#6,#6,  ,  ,  ,  ,  ,  ,  ,  ,  ,  ,  ,  ,  ,  ,  ,  ,  ,  ,  ,  ,  ,  ,  ,  ,  ,  ,  ,  ,  ,  ,  ,  ,  ,  ,  ,#0,#0,#0,#0
#0,#0,#0,#0,#6,#6,#6,#6,#6,  ,  ,  ,  ,  ,  ,  ,  ,  ,  ,  ,  ,  ,  ,  ,  ,  ,  ,  ,  ,  ,  ,  ,  ,  ,  ,  ,  ,  ,  ,  ,  ,  ,  ,  ,#0,#0,#0,#0
#0,#0,#0,#0,#6,#6,#6,#6,#6,  ,  ,  ,  ,  ,  ,  ,  ,  ,  ,  ,  ,  ,  ,  ,  ,  ,  ,#3,#3,#3,#3,#3,#3,#3,#3,#3,#3,#3,#3,#3,#3,#3,#3,#3,#0,#0,#0,#0
#0,#0,#0,#0,#6,#6,#6,#6,#6,  ,  ,  ,  ,  ,  ,  ,  ,  ,  ,  ,  ,  ,  ,  ,  ,  ,  ,#3,#3,#3,#3,#3,#3,#3,#3,#3,#3,#3,#3,#3,#3,#3,#3,#3,#0,#0,#0,#0
#0,#0,#0,#0,#6,#6,#6,#6,#6,  ,  ,  ,  ,  ,  ,  ,  ,  ,  ,  ,  ,  ,  ,  ,  ,  ,  ,#3,#3,#3,#3,#3,#3,#3,#3,#3,#3,#3,#3,#3,#3,#3,#3,#3,#0,#0,#0,#0
#0,#0,#0,#0,#6,#6,#6,#6,#6,  ,  ,  ,  ,  ,  ,  ,  ,  ,  ,  ,  ,  ,  ,  ,  ,  ,  ,#3,#3,#3,#3,#3,#3,#3,#3,#3,#3,#3,#3,#3,#3,#3,#3,#3,#0,#0,#0,#0
#0,#0,#0,#0,#6,#6,#6,#6,#6,  ,  ,  ,  ,  ,  ,  ,  ,  ,  ,  ,  ,  ,  ,  ,  ,  ,  ,#3,#3,#3,#3,#3,#3,#3,#3,#3,#3,#3,#3,#3,#3,#3,#3,#3,#0,#0,#0,#0
#0,#0,#0,#0,#6,#6,#6,#6,#6,  ,  ,  ,  ,  ,  ,  ,  ,  ,  ,  ,  ,#8,#8,#8,#8,  ,  ,#3,#3,#3,#3,#3,#3,#3,#3,#3,#3,#3,#3,#3,#3,#3,#3,#3,#0,#0,#0,#0
#0,#0,#0,#0,#0,#0,#0,#0,#0,#0,#0,#0,#0,#0,#0,#0,#0,#0,#0,#0,#0,#0,#0,#0,#0,#0,#0,#0,#0,#0,#0,#0,#0,#0,#0,#0,#0,#0,#0,#0,#0,#0,#0,#0,#0,#0,#0,#0
#0,#0,#0,#0,#0,#0,#0,#0,#0,#0,#0,#0,#0,#0,#0,#0,#0,#0,#0,#0,#0,#0,#0,#0,#0,#0,#0,#0,#0,#0,#0,#0,#0,#0,#0,#0,#0,#0,#0,#0,#0,#0,#0,#0,#0,#0,#0,#0
#0,#0,#0,#0,#0,#0,#0,#0,#0,#0,#0,#0,#0,#0,#0,#0,#0,#0,#0,#0,#0,#0,#0,#0,#0,#0,#0,#0,#0,#0,#0,#0,#0,#0,#0,#0,#0,#0,#0,#0,#0,#0,#0,#0,#0,#0,#0,#0
#0,#0,#0,#0,#0,#0,#0,#0,#0,#0,#0,#0,#0,#0,#0,#0,#0,#0,#0,#0,#0,#0,#0,#0,#0,#0,#0,#0,#0,#0,#0,#0,#0,#0,#0,#0,#0,#0,#0,#0,#0,#0,#0,#0,#0,#0,#0,#0